################################
#   ..........  .              #
#  #############  ######   ##  #
#        #           #         #
#     ########       #         #
#                    #         #
#    #####                     #
#    #   #   ######### #  ######
#    #   #                     #
#                              #
################################